WWWWGGGSGGGGGGSGGGGGGSGGGGGGSGGG
WWWWWWSGGGGGGSGGGGGGSGGGGGGSGGGG
GGWWWWWWGGGGSGGGGGGSGGGGGGSGGGGG
GGGGWWWWWWGSGGGGGGSGGGGGGSGGGGGG
GGGSGGWWWWWWGGGGGSGGGGGGSGGGGGGS
GGSGGGGGWWWWWWGGSGGGGGGSGGGGGGSG
GSGGGGGGSGWWWWWWGGGGGGSGGGGGGSGG
SGGGGGGSGGGGWWWWWWGGGSGGGGGGSGGG
GGGGGGSGGGGGGSWWWWWWSGGGGGGSGGGG
GGGGGSGGGGGGSGGGWWWWWWGGGGSGGGGG
GGGGSGGGGGGSGGGGGGWWWWWWGSGGGGGG
GGGSGGGGGGSGGGGGGSGGWWWWWWGGGGGS
GGSGGGGGGSGGGGGGSGGGGGWWWWWWGGSG
GSGGGGGGSGGGGGGSGGGGGGSGWWWWWWGG
SGGGGGGSGGGGGGSGGGGGGSGGGGWWWWWW
GGGGGGSGGGGGGSGGGGGGSGGGGGGSWWWW
GGGGGSGGGGGGSGGGGGGSGGGGGGSGGGWW
GGGGSGGGGGGSGGGGGGSGGGGGGSGGGGGG
