WWWWWWWWWWWWWWWWWWWWWWWWWWWWWWWW
WWWWWWWWWSGSGSWWWWWWWWWWWWWWWWWW
WWWWWWWWGGGGSSWWWWWWWWSGGSSWWWWW
WWWWWWWWGSGSSSSSWWWWWGSGGGSGWWWW
WWWWWWWWSGSGGGSSGWWWWSSGGGSGWWWW
WWWWWWWWWSGSSSSGGWWWWGSGGSGSWWWW
WWWWWWWWWGGGSGGGGWWWWWGGGSSSWWWW
WWWWWWWWWWGSGGGGWWWWWWSGGGSGWWWW
WWWWWWWWWWWWWWWWWWWWWWGGGSGGGWWW
WWWWWWWWWWWWWWWWGGSGGWGSSGGGWWWW
WWWWWWWWWWWWWWWSSSSSGWWSGGSGWWWW
WWWWWWWWWWWWWWWSGSGGGGWWWWWWWWWW
WWWWWWWWWWWWWWWWGGGSSGWWWWWWWWWW
WWWWWWWWWWWWWWWWGSGGGWWWWWWWWWWW
WWWWWWWWWWWWWWWWWWWWWWWWWWWWWWWW
WWWWWWWWWWWWWWWWWWWWWWWWWWWWWWWW
WWWWWWWWWWWWWWWWWWWWWWWWWWWWWWWW
WWWWWWWWWWWWWWWWWWWWWWWWWWWWWWWW
