GGGGGGGGGGGGGGGGGGGGGGGGGGGGGGGG
GGGGGGGGGGGGGGGGGGGGGGGGGGGGGGGG
GGGGGGGGGGGGGGGGGGGGGGGGGGGGGGGG
GGGGGGGGGGGGGGGGGGGGGGGGGGGGGGGG
GGGGGGGGGGGGGGGGGGGGGGGGGGGGGGGG
GGGGGGGGGGGGGGGGGGGGGGGGGGGGGGGG
SSSSGSSSSGSSSSGSSSSGSSSSGSSSSGSS
SSSGSSSSGSSSSGSSSSGSSSSGSSSSGSSS
SSGSSSSGSSSSGSSSSGSSSSGSSSSGSSSS
SGSSSSGSSSSGSSSSGSSSSGSSSSGSSSSG
GSSSSGSSSSGSSSSGSSSSGSSSSGSSSSGS
SSSSGSSSSGSSSSGSSSSGSSSSGSSSSGSS
WWWWWWWWWWWWWWWWWWWWWWWWWWWWWWWW
WWWWWWWWWWWWWWWWWWWWWWWWWWWWWWWW
WWWWWWWWWWWWWWWWWWWWWWWWWWWWWWWW
WWWWWWWWWWWWWWWWWWWWWWWWWWWWWWWW
WWWWWWWWWWWWWWWWWWWWWWWWWWWWWWWW
WWWWWWWWWWWWWWWWWWWWWWWWWWWWWWWW
